{
	"layers":[
		[
			1, 1, 1, 1, 1, 1, 1, 1, 1,
			1, 1, 1, 1, 1, 1, 1, 1, 1,
			1, 1, 1, 1, 1, 1, 1, 1, 1,
			1, 1, 1, 1, 1, 1, 1, 1, 1,
			1, 1, 1, 1, 1, 1, 1, 1, 1,
			1, 1, 1, 1, 1, 1, 1, 1, 1
		],[
			2, -1, 2, -1, 2, -1, 2, -1, 2,
			-1, 2, -1, 2, -1, 2, -1, 2, -1,
			2, -1, 2, -1, 2, -1, 2, -1, 2,
			-1, 2, -1, 2, -1, 2, -1, 2, -1,
			2, -1, 2, -1, 2, -1, 2, -1, 2,
			-1, 2, -1, 2, -1, 2, -1, 2, -1
		]
	],
	"models":[

	],
	"tileset":"tileset.json",
	"dimensions":[9,6]
}